"filename", "language", "C++", "comment", "blank", "total"
"d:\MyWorks\MyWorks\Experiment of programming\Project3(HenBnb)\code\calendar.cpp", "C++", 38, 3, 11, 52
"d:\MyWorks\MyWorks\Experiment of programming\Project3(HenBnb)\code\calendar.h", "C++", 7, 1, 2, 10
"d:\MyWorks\MyWorks\Experiment of programming\Project3(HenBnb)\code\date.cpp", "C++", 224, 12, 31, 267
"d:\MyWorks\MyWorks\Experiment of programming\Project3(HenBnb)\code\date.h", "C++", 59, 1, 7, 67
"d:\MyWorks\MyWorks\Experiment of programming\Project3(HenBnb)\code\dateinfo.cpp", "C++", 639, 13, 54, 706
"d:\MyWorks\MyWorks\Experiment of programming\Project3(HenBnb)\code\guest.cpp", "C++", 744, 25, 56, 825
"d:\MyWorks\MyWorks\Experiment of programming\Project3(HenBnb)\code\guest.h", "C++", 41, 13, 14, 68
"d:\MyWorks\MyWorks\Experiment of programming\Project3(HenBnb)\code\info.h", "C++", 217, 19, 39, 275
"d:\MyWorks\MyWorks\Experiment of programming\Project3(HenBnb)\code\interface.cpp", "C++", 57, 5, 8, 70
"d:\MyWorks\MyWorks\Experiment of programming\Project3(HenBnb)\code\interface.h", "C++", 10, 4, 6, 20
"d:\MyWorks\MyWorks\Experiment of programming\Project3(HenBnb)\code\landlord.cpp", "C++", 345, 14, 27, 386
"d:\MyWorks\MyWorks\Experiment of programming\Project3(HenBnb)\code\landlord.h", "C++", 27, 6, 10, 43
"d:\MyWorks\MyWorks\Experiment of programming\Project3(HenBnb)\code\main.cpp", "C++", 19, 3, 8, 30
"d:\MyWorks\MyWorks\Experiment of programming\Project3(HenBnb)\code\moneyinfo.cpp", "C++", 212, 0, 19, 231
"d:\MyWorks\MyWorks\Experiment of programming\Project3(HenBnb)\code\repairinfo.cpp", "C++", 293, 0, 27, 320
"d:\MyWorks\MyWorks\Experiment of programming\Project3(HenBnb)\code\reservedinfo.cpp", "C++", 125, 0, 9, 134
"d:\MyWorks\MyWorks\Experiment of programming\Project3(HenBnb)\code\room.cpp", "C++", 83, 0, 10, 93
"Total", "-", 3140, 119, 338, 3597