"filename", "language", "XML", "C++", "Log", "Markdown", "comment", "blank", "total"
"d:\MyWorks\MyWorks\Experiment of programming\Project3(HenBnb)\Project3(HenBnb).vcxproj", "XML", 153, 0, 0, 0, 0, 0, 153
"d:\MyWorks\MyWorks\Experiment of programming\Project3(HenBnb)\TODO.md", "Markdown", 0, 0, 0, 4, 0, 4, 8
"d:\MyWorks\MyWorks\Experiment of programming\Project3(HenBnb)\code\calendar.cpp", "C++", 0, 38, 0, 0, 3, 11, 52
"d:\MyWorks\MyWorks\Experiment of programming\Project3(HenBnb)\code\calendar.h", "C++", 0, 7, 0, 0, 1, 2, 10
"d:\MyWorks\MyWorks\Experiment of programming\Project3(HenBnb)\code\date.cpp", "C++", 0, 224, 0, 0, 12, 31, 267
"d:\MyWorks\MyWorks\Experiment of programming\Project3(HenBnb)\code\date.h", "C++", 0, 59, 0, 0, 1, 7, 67
"d:\MyWorks\MyWorks\Experiment of programming\Project3(HenBnb)\code\dateinfo.cpp", "C++", 0, 648, 0, 0, 14, 54, 716
"d:\MyWorks\MyWorks\Experiment of programming\Project3(HenBnb)\code\guest.cpp", "C++", 0, 744, 0, 0, 25, 56, 825
"d:\MyWorks\MyWorks\Experiment of programming\Project3(HenBnb)\code\guest.h", "C++", 0, 41, 0, 0, 13, 14, 68
"d:\MyWorks\MyWorks\Experiment of programming\Project3(HenBnb)\code\info.h", "C++", 0, 229, 0, 0, 19, 39, 287
"d:\MyWorks\MyWorks\Experiment of programming\Project3(HenBnb)\code\interface.cpp", "C++", 0, 57, 0, 0, 5, 8, 70
"d:\MyWorks\MyWorks\Experiment of programming\Project3(HenBnb)\code\interface.h", "C++", 0, 10, 0, 0, 4, 6, 20
"d:\MyWorks\MyWorks\Experiment of programming\Project3(HenBnb)\code\landlord.cpp", "C++", 0, 345, 0, 0, 30, 31, 406
"d:\MyWorks\MyWorks\Experiment of programming\Project3(HenBnb)\code\landlord.h", "C++", 0, 27, 0, 0, 6, 10, 43
"d:\MyWorks\MyWorks\Experiment of programming\Project3(HenBnb)\code\main.cpp", "C++", 0, 19, 0, 0, 3, 7, 29
"d:\MyWorks\MyWorks\Experiment of programming\Project3(HenBnb)\code\moneyinfo.cpp", "C++", 0, 256, 0, 0, 0, 18, 274
"d:\MyWorks\MyWorks\Experiment of programming\Project3(HenBnb)\code\repairinfo.cpp", "C++", 0, 293, 0, 0, 1, 27, 321
"d:\MyWorks\MyWorks\Experiment of programming\Project3(HenBnb)\code\reservedinfo.cpp", "C++", 0, 125, 0, 0, 0, 9, 134
"d:\MyWorks\MyWorks\Experiment of programming\Project3(HenBnb)\code\room.cpp", "C++", 0, 83, 0, 0, 0, 10, 93
"d:\MyWorks\MyWorks\Experiment of programming\Project3(HenBnb)\x64\Debug\Project3(HenBnb).log", "Log", 0, 0, 2, 0, 0, 1, 3
"Total", "-", 153, 3205, 2, 4, 137, 345, 3846